1111111111111111111111111111111111111111111111111111111111111111111111111111111111111111111111111111
0000000000000000000000000000000000000000000000000000000000000000000000000000000000000000000000000000
0111111111111111111111111111111111111111111111111111111111111111111111111111111111111111111111111110
0111111111111111111111111111111111111111111111111111111111111111111111111111111111111111111111111110
0111111000000000000000000000000000000000000000000000000000000000000011111111111111111111111111111110
0111111011111111111111111111111111111111111111111111111111111111111011111111111111111111111111111110
0000000011111111111111111111111111111111111111111111111111111111111011111111111111111111111111111110
1111111111111111111111111111111111111111111111111111111111111111111011111111111111111111111111111110
1111111111111111111111111111111111111111111111111111111111111111111011111111111111111111111111111110
1111111111111111111111111111111110000000000000000001111111111111111011111111111111111111111111111110
1111111111111111111111111111111110111111111111111101111111111111111011111111111111111111111111111110
1111111111111111111111111111111110111111111111111101111111111111111011111111111111111111111111111110
1111111111111111111111111111111110111111111111111101111111111111111011111111111111111111111111111110
1111111111111111111111111111111110111111111111111101111111111111111011111111111111111111111111111110
1111111111111111111111111111111110111111111111111101111111111111111011111111111111111111111111111110
1111111111111111111111111111111110111111111111111101111111111111111011111111111111111111111111111110
1111111111111111111000000000000000111111111111111101111111111111111011111111111111111111111111111110
1111111111111111111011111111111111111111111111111101111111111111111011111111111111111111111111111110
1111111111111111111011111111111111111111111111111101111111111111111011111111111111111111111111111110
1111111111111111111011100000000000111111111111111101111111111111111011111111111111111111111111111110
1111111111111111111011101111111110111111111111111101111111111111111011111111111111111111111111111110
1111111111111111111011101111111110111111111111111101111111111111111011111111111111111111111111111110
1111111111111111111011101111111110111111111111111101111111111111111000000000000000000000000000111000
1111111111111111111011101111111110111111111111111101111111111111111111111111111111111111111110111011
0000000000000000000011101111111110111111111111111101111111111111111111111111111111111111111110111011
0111111111111111111111101111111110111111111111111101111111111111111111111111111111111111111110111011
0111111111111111111111101111111110111111111111111101111111111111111111111111111111111111111110111011
0111111111111111111111101111111110111111111111111101111111111111111111111111111111111111111110111011
0111111111111111111111101111111110000000011100000001111111111011111111111111111111111111111110111011
0111111111111111111111101111111111111111011100000000000000000011111111111111111111111111111110111011
0111111111111111111111101111111111111111011111111111111111111011111111111111111111111111111110111011
0111111111111111111111101111111111111111011111111111111111111011111111111111111111111111111110111011
0111111111111111111111101111111111111111000000000000000000111011111111111111111111111111111110111011
0111111111111111111111101111111111111111111111111111111110111011111111111111111111111111111110111011
0111111111111111111111101111111111111111111111111111111110111011111111111111111111111111111110111011
0111111111111111111111101111111111111111111111111111111110111011111111111111111111111111111110111011
0111111111111111111111101111111111111111111111111111111110111011111111111111111111111111111110111011
0111111111111111111111101111111111111111111111111111111110111011111111111111111111111111111110111011
0111111111111111111111100000000000011111111111111111111110111011111111111111111111111111111110111011
0111111111111111111111111111111111011111111111111111111110111011111111111111111111111111111110111011
0111111111111111111111111111111111011111111111111111111110111011111111111111111111111111111110111011
0000000000000000000000000000000111011111111111111111111110111011111111111110000000000000000000111000
1111111111111111111111111111110111011111111111111111111110111011111111111110111111111111111111111110
1111111111111111111111111111110111011111111111111111111110111011111111111110111111111111111111111110
1111111111111111111111111111110111011111111111111111111110111011111111111110111111111111111111111110
1111111111111111111111111111110111011111111111111111111110111011111111111110111111111111111111111110
1111111111111111111111111111110111011111111111111100000000111000000000000000111111111111111111111110
1111111111111111111111111111110111011111111111111101111111111111111111111111111111111111111111111110
1111111111111111111111111111110111011111111111111101111111111111111111111111111111111111111111111110
1111111111111111111111111111110111011111111111111101110000000000000000000011111111111111111111111110
1111111111111111111111111111110111011111111111111101110111111111111111111011111111111111111111111110
1111111111111111111111111111110111011111111111111101110111111111111111111011111111111111111111111110
1111111111111111111111111111110111011111111111111101110111111111111111111011111111111111111111111110
1111111111111111111111111111110111011111111111111101110111111111111111111011111111111111111111111110
1111111111111111111111111111110111011111111111111101110111111111111111111011111111111111111111111110
1111111111111111111111111111110111011111111111111101110111111111111111111011111111111111111111111110
1111111111111111111111111111110111011111111111111101110111111111111111111011111111111111111111111110
1111111111111111111111111111110111011111111111111101110111111111111111111011111111111111111111111110
1111111111111111111111111111110111011111111111111101110111111111111111111011111111111111111111111110
1111111111111111111111111111110111011111111111111101110111111111111111111011111111111111111111111110
0000000000000000001111111111110111011111111111111101110111111111111111111011111111111111111111111110
0111111111111111101111111111110111011111111111111101110111111111111111111011111111111111111111111110
0111111111111111100000000000000111000000000000000001110111111111111111111011111111111111111111111110
0111111111111111111111111111111111111111111111111111110111111111111111111011111111111111111111111110
0111111111111111111111111111111111111111111111111111110111111111111111111000000000000000000000000000
0111111111111111100000000000000000000000000011100000000111111111111111111111111111111111111111111111
0111111111111111101111111111111111111111111011101111111111111111111111111111111111111111111111111111
0111111111111111101111111111111111111111111011101111111111111111111111111111111111111111111111111111
0111111111111111101111111111111111111111111011101111111111111111111111111111111111111111111111111111
0111111111111111101111111111111111111111111011101111111111111111111111111111111111111111111111111111
0111111111111111101111111111111111111111111011101111111111111111111111111111111111111111111111111111
0000000001100000001111111111111111111111111011101111111111111111111111111111111111111111111111111111
1111111101101111111111111111111111111111111011101111111111111111111111111111111111111111111111111111
1111111101101111111111111111111111111111111011101111111111111111111111111111111111111111111111111111
1111111101101111111111111111111111111111111011101111111111111111111111111111111111111111111111111111
1111111101101111111111111111111111111111111011101111111111111111111111111111111111111111111111111111
1111111101101111111111111111111111111111111011101111111111111111111111111111111111111111111111111111
1111111101101111111111111111111111111111111011101111111111111111111111111111111111111111111111111111
1111111101101111111111111111111111111111111011101111111111111111111111111111111111111111111111111111
1111111101101111111111111111111111111111111011101111111000000000000000000000000000000000000000000000
1111111101101111111111111111111111111111111011101111111011111111111111111111111111111111111111111110
1111111101101111111111111111111111111111111011101111111011111111111111111111111111111111111111111110
1111111101101111111111111111111111111111111011101111111011111111111111111111111111111111111111111110
1111111101101111111111111111111111111111111011101111111011111111111111111111111111111111111111111110
0000000001100000000001111111111111111111111011101111111011111111111111111111111111111111111111111110
0111111111111111111101111111111111111111111011101111111011111111111111111111111111111111111111111110
0111111111111111111101111111111111111111111011101111111011111111111111111111111111111111111111111110
0111111111111111111101111111111111111111111011100000000011111111111111111111111111111111111111111110
0111111111111111111101111111111111111111111011111111111111111111111111111111111111111111111111111110
0111111111111111111101111111111111111111111011111111111111111111111111111111111111111111111111111110
0111111111111111111101111111111111111111111000000000000011111111111111111111111111111111111111111110
0111111111111111111101111111111111111111111111111111111011111111111111111111111111111111111111111110
0111111111111111111101111111111111111111111111111111111011111111111111111111111111111111111111111110
0111111111111111111101111111111111111111111111111111111011111111111111111111111111111111111111111110
0111111111111111111101111111111111111111111111111111111011111111111111111111111111111111111111111110
0111111111111111111101111111111111111111111111111111111011111111111111111111111111111111111111111110
0111111111111111111101111111111111111111111111111111111011111111111111111111111111111111111111111110
0111111111111111111101111111111111111111111111111111111011111111111111111111111111111111111111111110
0111111111111111111101111111111111111111111111111111111011111111111111111111111111111111111111111110
0000000000000000000001111111111111111111111111111111111000000000000000000000000000000000000000000000