0111111111111111111111111111111111111111111111111111111111111111111111111111111111111111111111111110
0111111111111111111111111111111111111111111111111111111111111111111111111111111111111111111111111110
0111111111111111111111111111111111111111111111111111111111111111111111111111111111111111111111111110
0111111111111111111111111111111111111111111111111111111111111111111111111111111111111111111111111110
1111111111111111111111111111111111111111111111111111111111111000000011111111111111111111111111111111
1111111111111111111111111111111111111111111111111111111111111011111011111111111111111111111111111111
1111111111111111111111111111111111111111111111111111111111111011111011111111111111111111111111111111
1111111111111111111111111111111111111111111111111111111111111011111011111111111111111111111111111111
1111111111111111111111111111111111111111111111111111111111111011111011111111111111111111111111111111
1111111111111111111111111111111111111111111111111111111111111101110011111111111111111111111111111111
1111111111111111111111111111111111111111111111111111111111111101110111111111111111111111000011111111
1111111111111111111111111111111111111111111111111111111111111101110111111111111111111111011011111111
1111111111111111111111111111111111111111111111111111111111111101110111111111111111111111011011111111
1111111111111111111111111111111111111111111111111111111111111101110111111111111111111110111101111111
1111111111111111111111111111111111111111111111111111111111111101110111111111111111111110111101111111
1111111111111111111111111111111111111111111111111111111111111101110111111111111111111110111101111111
1111111111111111111111111111111111111111111111111111111111111101110111111111111111111110111101111111
1111111111111111111111111111111111111111111111111111111111111101110111111111111111111110111101111111
1111111111111111111111111111111111111111111111111111111111111101110111111111111111111110111101111111
1111111111111111111111111111111111111111111111111111111111111101110111111111111111111110111101111111
1111111111111111111111111111111111111111111111111111111111111101110111111111111111111110111101111111
1111111111111111111111111111111111111111111111111111111111111101110111111111111111111110111101111111
1111111111111111111111111111111111111111111111111111111111111101110111111111111111111110111101111111
1111111111111111111111111111111111111111111111111111100000000001110000000000011111111110111101111111
1111111111111111111111111111111111111111111111111111101111111111111111111111011111111110111101111111
0111111111111111111111101111111111111111111111111111101111111111111111111111011111111110111101111111
0000000000000000000000001111111111111111111000000011101111111111111111111111011111111110111101111111
0111111111011111111111101111111111111111110011111011101111111111111111111111011111111110111101111111
0111101111011111111110001111111111111111111011111011101111111111111111111111011111111110111101111111
0111000111011111111110001111111111111111111011111011101111111111111111111111011111111110111101111111
0111000111011111111111100000000000000000000011111011101111111111111111111111011111111110111101111111
0111111111011111111111101111111111111111111111111011101111111111111111111111011111111110111101111111
0111111111011111111110001111111111111111111111111011101111111111111111111111011111111110111101111111
0111111111011111111110001111111111111111111111111011101111111111111111111111011111111110111101111111
0000111000011111111111101111111111111111111111111000001111111111111111111111011111111110111101111111
0000111000011111111111111111111111111111111111111111111111111111111111111111011111111110111101111111
0111111111111111111111111111111111111111111111111111111111111111111111111111011111111110111101111111
0111111111111111111111101111111111111111111111100000001111111111111111111111000000000000111101111111
0100111111111111111110001111111111111111111111101111101111111111111111111111111111111111111101111111
0100111111111111111110001111111111111111111111101111101111111111111111111111111111111111111101111111
0111111111111111111111101111111111111111111111101111101111111111111111111111111111111111111101111111
0100100111111111111111101111111111111111111111101111110000000011000000000000000000000000000001111111
0100100111111111111110001111111111111111111111101111111111111011011111111111111111111111111111111111
0111111111111111111110001111111111111111111111101111111111111011011111111111111111111111111111111111
0000000000000000000000000000000000000000000000001111111111111011011111111111111111111111111111111111
1111111111111111111111111111111111111111111111111111111111111011011111111111111111111111111111111111
1111111111111111111111111111111111111111111111111111111111111011011111111111111111111111111111111111
1111111111111111111111111111111111111111111111111111111111111011011111111111111111111111111111111111
1111111111111111111111111111111111111111111111111111111111111011011111111111111111111111111111111111
1111111111111111111111111111111111111111111111111111111111111011011111111111111111111111111111111111
1111111111111111111111111111111111111111111111111111111111111011011111111111111111111111111111111111
1111111111111111111111111111111111111111111111111111111111111011011111111111111111111111111111111111
1111111111111111111111111111111111111111111111111111110000000011000000111111111111111111111111111111
1111111111111111111111111111111111111111111111111111101111111111111110111111111111111111111111111111
1111111111111111111111111111111111111111111111111111101111111111111110111111111111111111111111111111
1111111111111111111111111111111111111111111111111111101111111111111110111111111111111111111111111111
1111111111111111111111111111111111111111111111111111101111111111111110111111111111111111111111111111
1111111111111111111111111111111111111111111111111111101111111111111110111111111111111111111111111111
1111111111111111111111111111111111111111111111111111101111111111111110111111111111111111111111111111
1111111111111111111111111111111111111111111111111111101111111111111110111111111111111111111111111111
1111111111111111111111111111111111111111111111111111101111111111111110000000111111111111111111111111
1111111111111111111111111111111111111111111111000000001111111111111111111111011111111111111111111111
1111111111111111111111111111111111111111111111011111111111111111111111111111011111111111111111111111
1111111111111111111111111111111111111111111111011101111111111111111111111111011111111111111111111111
1111111111111111111111111111111111111111111111011101111111111111111111111111011111111111111111111111
1111111111111111111111111111111111111111111111011111111111111111111111111111011111111111111111111111
1111111111111111111111111111111111111111111111011111111111111111111111111111011111111111111111111111
1111111111111111111111111111111111111111111111011111111111111111111111111111011111111111111111111111
1111111111111111111111111111111111111111111111011111111111111111111111111111011111111111111111111111
1111111111111111111111111111111111111111111111011111111111111111111111111111011111111111111111111111
1111111111111111111111111111111111111111111111011111111111111111111111111111011111111111111111111111
1111111111111111111111111111111111111111111111011101111111111111111111111111000000000000000000000000
1111111111111111111111111111111111111111111111011101111111111111111111111111111111111111111111111110
1111111111111111111111111111111111111111111111011111111111111111111111111111111111111111111111111110
1111111111111111111111111111111111111111111111011111111111111111111111111111111111111111111111111110
1111111111111111111111111111111111111111111111011111111111111111111111111111111111111111111111111110
1111111111111111111111111111111111111111111111011111111111111111111111111111111111111111111111111110
1111111111111111111111111111111111111111111111011111111111111111111111111111111111111111111111111110
1111111111111111111111111111111111111111111111011111111111111111111111111111111111111111111111111110
1111111111111111111111111111111111111111111111011111111111111111111111111111111111111111111111111110
1111111111111111111111111111111111111111111111011111111111111111111111111111111111111111111111111110
1111111111111111111111111111111111111111111111011111111111111111111111111111111111111111111111111110
1111111111111111111111111111111111111111111111000000000000000000000000000000000000000000111100000000
1111111111111111111111111111111111111111111111111111111111111111111111111011111111111111111111111110
1111111111111111111111111111111111111111111111111111111111111111111111111011111111111111111111111110
1111111111111111111111111111111111111111111111111111111111111111111111111011111111111111111111111110
1111111111111111111111111111111111111111111111111111111111111111111111111011100000111111111111111110
1111111111111111111111111111111111111111111111111111111111111111111111111011111111111111111111111110
1111111111111111111111111111111111111111111111111111111111111111111111111011111111111111111111111110
1111111111111111111111111111111111111111111111111111111111111111111111111011111111111111111111111110
1111111111111111111111111111111111111111111111111111111111111111111111111011111111111111111111111110
1111111111111111111111111111111111111111111111111111111111111111111111111011111111111111111111111110
1111111111111111111111111111111111111111111111111111111111111111111111111011111111111111111111111110
1111111111111111111111111111111111111111111111111111111111111111111111111011111111111111111111111110
1111111111111111111111111111111111111111111111111111111111111111111111111011111111111111111111111110
1111111111111111111111111111111111111111111111111111111111111111111111111000000000000000000000000000
1111111111111111111111111111111111111111111111111111111111111111111111111011111111111111111111111110
1111111111111111111111111111111111111111111111111111111111111111111111111011111111111111111111111110
1111111111111111111111111111111111111111111111111111111111111111111111111011111111111111111111111110
1111111111111111111111111111111111111111111111111111111111111111111111111000000000000000000000000000