0000000000011111111111100000000000000000111111111110000000000111111111111111111111111111111111111111
0110111011011111111111101011111111100110111111111110111110010111111111111111111111111111111111111111
0000111000011111111111100011111111100110111111111110111111110111111111111111111111111111111111111111
0111111111000000000000001111111111111110111111111110111111110111111111111111111111111111111111111111
0111111111111111111111111111111111111110111111111110111111110111111111111111111111111111111111111111
1111111111111111111111111111111111111110111111111110111111110111111111111111111111111111111111111111
1111111111111111111111111111111111111110111111111110000110000111111111111111111111111111111111111111
0111111111111111111111111111111111111110111111111111110110111111111111111111111111111111111111111111
0111111111000000000000001111111111111110111111111111110110111111111111111111111111111111111111111111
0111111111011111111111101111111111111110111111111111110110000000001111111111111111111111111111111111
0111111111011111111111101111111111111110111111111111110111111111101111111111111111111111111111111111
0000000000011111111111101111111111111110111111111111110111111111101111111111111111111111111111111111
1111111111111111111111101111111111111110111111111111110111111111101111111111111111111111111111111111
1111111111111111111111100000000000001100111111111111110000000001101111111111111111111111111111111111
1111111111111111111111111111111111101101111111111111111111111101100000000000000000000000000000000001
1111111111111111111111111111111111101101111111111111111111111101111111111111111111111001111100111101
1111111111111111111111111111111111101101111111111111111111111101111111111111111111111111111111111101
1111111111111111111111111111111111101101111111111111111111111101111111111111111111111111111111111101
1111111111111111111111111111111111101101111111111111111111111101111111111111111111111111111111111101
1111111111111111111111111000000000001100000000000011111111111101111111111111111111111111111111111101
1111111111111111111111111011001111111111111000111011111111111101111111111111111111111111111111111101
1111111111111111111111111011111111111111111111111011111111111101111111111111111111111111111111111101
1111111111111111111111111011111111111111111111111011111111111101111111111111111111111111111111111101
1111111111111111111111111011111111111111111111111011111111111101111111111111111111111111111111111101
1111111111111111111111111011111111111111111111111011111111111101111111111111111111111111111111111101
1111111111111111111111111011111111111111111111111011111111111100011111111111111111111111111111111101
1111111111111111111111111011111111111111111111111011111111111100011111111111111111111111111111111101
1110000000000000000000000011111111111111111111111000000000000001111111111111111111111111111110111101
1110001111111111111111111111111111111111111111111111111111111111111111111111111111111111111111001101
1110011111111111111111111111111111111111111111111111111111111111111111111111111111111111111111011101
1110111111111111111111111111111111111111111111111111111111111111111111111111111111111111111111111101
1110111111111111111111111111111111111111111111111111111111111111111111111111111111111111111110111101
1110111100000000000000000011111111111111111111111000000000000001111111111111111111111111111111111101
1110111101111111111111111011111111111111111111111011111111111101111111111111111111111111111111111101
1110111101111111111111111011111111111111111111111011111111111101111111111111111111111111111111111101
1110111101111111111111111011111111111111111111111011111111111100011111111111111111111111111111111101
1110111101111111111111111011111111111111111111111011111111111100011111111111111111111111111111111101
1110111101111111111111111011111111111111111111111011111111111101111111111111111111111111111111111101
1110111101111111111111111011111111111111111111111011111111111101111111111111111111111111111111111101
1110111101111111111111111011111111111111111111111011111111111100000000000000000000000000000000000001
1110111101111111111111111000000000000000000000000011111111111111111111111111111111111111111111111111
1110111101111111111111111111111111111111111111111111111111111111111111111111111111111111111111111111
1110111101111111111111111111111111111111111111111111111111111111111111111111111111111111111111111111
1110111101111111111111111111111111111111111111111111111111111111111111111111111111111111111111111111
1110111101111111111111111111111111111111111111111111111111111111111111111111111111111111111111111111
1110111101111111111111111111111111111111111111111111111111111111111111111111111111111111111111111111
1110111101111111111111111111111111111111111111111111111111111111111111111111111111111111111111111111
1110111101111111111111111111111111111111111111111111111111111111111111111111111111111111111111111111
1110111101111111111111111111111111111111111111111111111111111111111111111111111111111111111111111111
1110111101111111111111111111111111111111111111111111111111111111111111111111111111111111111111111111
1110111101111111110000000000000000000000000000000001111111111111111111111111111111111111111111111111
1110111101111111110111001111110011111111111111001101111111111111111111111111111111111111111111111111
1110111101111111110111111111111111111111111111111101111111111111111111111111111111111111111111111111
1110111101111111110111111111111111111111111111111101111111111111110000000000000000000000000000000000
1110111100000000000111111111111111111111111111111101111111111111110111111111111111111111111111111110
1110111111111111111111111111111111111111111111111101111111111111110111111111111111111111111111111110
1110111111111111111111111111111111111111111111111101111111111111110111111111111111111111111111111110
1110011111111111111111111111111111111111111111111101111111111111110111111111111111111111111111111110
1110001111111111111111111111111111111111111111111101111111111111110111111111111111111111111111111110
1110000000000000000111111111111111111111111111111101111111111111110111111111111111111111111111111110
1111111111111111110111111111111111111111111111111101111111111111110111111111111111111111111111111110
1111111111111111110111111111111111111111111111111101111111111111110111111111111111111111111111111110
1111111111111111110111111111111111111111111111111101111111111111110111111111111111111111111111111110
1111111111111111110111111111111111111111111111111101111111111111110111111111111111111111111111111110
1111111111111111110111111111111111111111111111111101111111111111110111111111111111111111111111111110
1111111111111111110111111111111111111111111111111101111111111111110111111111111111111111111111111110
1111111111111111110111111111111111111111111111111101111111111111110111111111111111111111111111111110
1111111111111111110111111111111111111111111111111100000000000000000111111111111111111111111111111110
1111111111111111110111111111111111111111111111111111111111111111111111111111111111111111111111111110
1111111111111111110111111111111111111111111111111111111111111111111111111111111111111111111111111110
1111111111111111110111111111111111111111111111111111111111111111111111111111111111111111111111111110
1111111111111111110111111111111111111111111111111111111111111111111111111111111111111111111111111110
1111111111111111110111111111111111111111111111111100000000000000000111111111111111111111111111111110
1111111111111111110000000011100000000000000000000001111111111111110111111111111111111111111111111110
1111111111111111111111111011101111111111111111111111111111111111110111111111111111111111111111111110
1111111111111111111111111011101111111111111111111111111111111111110111111111111111111111111111111110
1111111111111111111111111011101111111111111111111111111111111111110111111111111111111111111111111110
1111111111111111111111111011101111111111111111111111111111111111110111111111111111111111111111111110
1111111111111111111111111011101111111111111111111111111111111111110111111111111111111111111111111110
1111111111111111111111111011101111111111111111111111111111111111110000000000000000000000000000110000
1111111111111111111111111011101111111111111111111111111111111111111111111111111111111111111110110111
1111111111111111111111111011101111111111111111111111111111111111111111111111111111111111111110110111
1111111111111111111111111011101111111111111111111111111111111111111111111111111111111111111110110111
1111111111111111111111111011101111111111111111111111111111111111111111111111111111111111111110110111
1111111111111110000000000011100000000000000011111111111111111111111111111111111111111111111110110111
1111111111111110100111111111111111111111001011111111111111111111111111111111111111111111111110110111
1111111111111110100111111111111111111111001011111111111111111111111111111111111111111111111110110111
1111111111111110111111111111111111111111111011111111111111111111111111111111111111111111111110110111
1111111111111110111111111111111111111111111011111111111111111111111111111111111111111111111110110111
1111111111111110111110001111111111111111111011111111111111111111111111111111111111111111110000110000
1111111111111110111110001111111110001111111011111111111111111111111111111111111111111111110000110000
1111111111111110111110001111111110001111111011111111111111111111111111111111111111111111110000110000
1111111111111110111111111111111110001111111011111111111111111111111111111111111111111111110111111110
1111111111111110111111111111111111111111111011111111111111111111111111111111111111111111110111111110
1111111111111110111111111111111111111111111011111111111111111111111111111111111111111111110111111110
1111111111111110111111111111111111111111111011111111111111111111111111111111111111111111110111111110
1111111111111110111111111111111111111111111011111111111111111111111111111111111111111111110111111110
1111111111111110111111111111111111111111111011111111111111111111111111111111111111111111110111111110
1111111111111110111111111111111111111111111011111111111111111111111111111111111111111111110000000000
1111111111111110000000000000000000000000000011111111111111111111111111111111111111111111111111111111